WWWWWWWWWWWWWWWWWWWWWWWWWWWWWWWWWWWWWWWW
WEEEEEE EEGEB EEEEEBEBEEEEEEE EEEEBEEEEW
WEBSBEEEEEE EEEEEEEEEBGEEBEEEE EEEEE EEW
WEEEEEEEEEE EE EEEEEBEBEEBEEEEEEEEBEEEEW
WBEBBEEEEEEEEEBEEEEEEBEEBEEEEBEEEBEEEEEW
WBEEBEEEEEEEEEBBEEBEEEEEEEEBEEEEEEBEB EW
WEEE EEBEEEEEEEEBEEEEEBE BEEEEEEEEBEBBEW
WWWWWWWWWWWWWWWWWWWWWWWWWWWWWWWEEEBEEBEW
WE EEEBEEGE EEBEBEEEEEEEEEEGEB EEEEEEBEW
WEEGEEEEEBEEEEE EEEEEEEEB  BEEGEEEEBEEEW
WEEEBEEBEBEEEEEEEEEEEEEEBBEBEEBEEEEEEEEW
WE BEEEEBEEEEEEEEBB EEEEEEEBEEBEGEEEE EW
WEBEE EEBE  EEEEEBEBGEEGEEEEBEEEBEEGEBEW
WEGBEEEEEEEEEEEEEEBBBEEBEEEEEEEEGEEEEEBW
WEEEEEEEEWWWWWWWWWWWWWWWWWWWWWWWWWWWWWWW
W  EEEEEEEEE EEEGEEEEBEEEEEBEEEBEEEEEEEW
WBBEEEEEEEEEBBEEBEEEEEEEEBEEEEEEBEB EEXW
WEBEEBEEEEEEEEBEEEEEBE  EEEEGEEEBEBBEEEW
WEEEEBGEE EEEEEEEEBEEEEEEBEBGEEEEEEBEEEW
WEEE EE EBEEBEBBEEEEEEEEEBEBGEEEEEEBEEBW
WEGEEEEBEEEEE EEEEEEEEE EBEEBEBEEEEEEBEW
WWWWWWWWWWWWWWWWWWWWWWWWWWWWWWWWWWWWWWWW